############################
#............##............#
#.####.#####.##.#####.####.#
#*####.#####.##.#####.####*#
#.####.#####.##.#####.####.#
#..........................#
#.####.##.########.##.####.#
#.####.##.########.##.####.#
#......##....##....##......#
######.##### ## #####.######
######.##### ## #####.######
######.##          ##.######
######.##          ##.######
######.## ###_#### ##.######
      .   # rpbo #   .      
######.## ######## ##.######
######.##....&.....##.######
######.##..........##.######
######.##.########.##.######
######.##.########.##.######
#............##............#
#.####.#####.##.#####.####.#
#.####.#####.##.#####.####.#
#*..##................##..*#
###.##.##.########.##.##.###
###.##.##.########.##.##.###
#......##....##....##......#
#.##########.##.##########.#
#.##########.##.##########.#
#............@.............#
############################
